1111111111111
1010011111001
1C00000000001
1P0011E000001
1111111111111
