111111111111111111111
1CC000000000000010111
111000111110000011111
100000000010000000001
10000000001100111E001
100001111100000000001
10000000000000000C001
111110000011100000001
100011100000000000001
100000011111110000001
100000000000000000001
10000000P000001111111
111110000000001C00001
1C0000000011111000001
100000111000000000001
100000000000011111101
100011100000000000001
100000000000000000C01
1000000000C0000000X01
111111111111111111111
