1111111111111
1010011111001
1CC0000000001
1P1011E0X0001
1111111111111
