111111111111111111111
100000000000000010111
110000111110000011111
100000000010000000001
100000000011001110001
100001111100000000001
100000000000000000001
111110000011100000001
100011100000000000001
100000011111110000001
100000111111000000001
1000001CPE01001111111
111110110111001000001
100000000011111000001
100000111000000000001
100000000000011111101
100011100000000000001
100000000000000000001
100000000000000000X01
111111111111111111111
