111111111111111111111
1PEC11111111111111111
11X111111111111111111
111111111111111111111
110000000111101111111
111111110111101111111
111111110111101111111
111111110111101111111
111111110111101111111
111111110111101111111
110000000000001111111
110111110111111111111
110111110111111111111
110111110111111111111
110111110111111111111
110111110111111111111
110111110000000111111
111111111111111111111
111111111111111111111
111111111111111111111
