111111111111
10000C000001
100000000001
1000000000E1
1P00000C0001
111111111111
