11111111111111111111111111111111111111111111111111
10000000000111000000000000000000111000000000000001
10P00000000111000000000000000000111000000000000001
10000000000111000000000000000000111000000000000001
11111100111111111100111111111100111111100111111111
10000000111000000000111000000000000000000111000001
10000000111000000000111000000000000000000111000001
10000000111000X00000111000000000000000000111000001
11100111111111111100111111111111111111100111111101
10000000000000000000000000000000000000000000000101
10000000000000000000000000000000000000000000000101
1000000000000000000000000X000000000000000000000101
11111111111111111111111111111111111111100000000101
10000000000000000000000000000000000000000000000101
10000000000000000000000000000000000000000000000101
10000000000C00000000000000000000000000000000000101
11111111111111111111111111111111111111111100111111
10000000111000000000111000000000000000000000000001
1000X000111000000000111000000000000000000000000001
10000000111000000000111000000000000000000000000001
11111100111111111100111111111100111111100111111111
10000000000111000000000000000000111000000000000001
10000000000111000000000000000000111000000000000001
1000X000000111000000000000000000111000000000000001
10000000000111000000000000000000111000000000000001
10000000000000000000000000000000000000000000000E01
11111111111111111111111111111111111111111111111111
